NO ./textures/purplestone.xpm
SO ./textures/bluestone.xpm
EA ./textures/wood.xpm
WE ./textures/eagle.xpm

F 89, 79, 87
C 168, 215, 230

        11111111111111111111111111
        1000000000110000000000001
        1011000001110000000000001
        1001000000000000000000001
111111111011000001110000000000001
100000000011000001110111111111111
11110111111101010000000010001
11110111111101011101010010001
11000000110101011100000010001
10000000000000001100000010001
1000000000000000001010000001
11000000101010001000011100N1111
11110111 1110101 101111010001
11111111 1111111 11111111111