NO ./textures/purplestone.xpm
SO ./textures/bluestone.xpm
EA ./textures/wood.xpm


WE              ./textures/redbrick.xpm

F 225, 0, 218
C 0, 225, 169

 111111
101E0001
10010001
10000001
 111111