NO ./textures/purplestone.xpm
SO ./textures/bluestone.xpm
EA ./textures/wood.xpm
WE ./textures/redbrick.xpm

F 220,100,0
C 225,30,0

 111111
100W0001
10000001
10000001
 111111